1111111111111
1P10000000001
1001000000001
1C00E00000001
1000000000001
1000000000001
1111111111111
