1111111111111111
1P00000000000001
1000000000000001
1000000000000001
1000000000000001
1000000000000001
1000000000000001
1000000000000001
1000000000000001
1000000000000001
1111111000000001
10000001C00000E1
1111111111111111
