1111111111
1P00100X01
1000000001
10000C00E1
1111111111