1111111111111111
1000010000C00C01
1000001000C00001
10C0000100000001
1100000010C00001
1C10P0C001100001
1001000001000001
1000100C010C0001
1000010000100001
100C000000100001
1000000000010001
10000C0000C000E1
1111111111111111
