1111111111
1P00000001
1011101101
1000C000E1
1C01111001
1111111111
