111111111111111111111111
1C0X00C10000X000P0000001
10000010001C000000000001
100C01000011111111111111
10X010000000000X00000001
10C000000000X00000000E01
111111111111111111111111