11011
1P0C1
10001
1E001
11111
