11111
0P0C1
10001
1E001
11111
