11111
1P1E1
10011
1C0E1
11111
