11111
1P0E1
100E1
1C001
11111
