111111111111
1P0000000001
101000000001
11C1000000E1
111111111111
