11111
1P0C1
10001
1E000
11110
