111111
1P1001
100101
1C0001
111111
