11111
1P0C1
11001
1E111
11111
