10.ox
.o....o...
.oooo....o
oo........
oo..o.oo.o
o...o.o...
o.....oo..
.o.oo...o.
.o...o.o.o
.........o
....o.o...
