111111111
1P1000C01
100100001
1C00000E1
111111111
