11111
1P101
10011
1C0E1
11111
