111111
1P1E11
100111
1C0E1
11111
