111111111
1P1000001
100100001
1C0000EE1
111111111
