11111
1P1P1
10011
1C0E1
11111
